F          255,206,226
C      0,255,242

NO ./texture/hotmess_karina.xpm






SO ./texture/hotmess_giselle.xpm



EA ./texture/hotmess_ningning.xpm





WE                 ./texture/hotmess_winter.xpm









        1111111111111111111111111
        1000000000110000000000001
        1011000001110000000000001
        100100000000000S000000001
111111111011000001110000000000001
100000000011000001111111111111111
11110111111111011101 10010001
11110111111111011101110010001
11000000110101011100000010001
10000000000100001100000010001
10000000001100011010100010001
1100000111010101111101111000111
11010111 1110101 101111010001
11111111 1111111 111111111111                 